1111111111111
1001000C000C1
1000011111001
1P0C11E00C001
1111111111111
